############
##n m#b  ###
#### #  ####
###     b###
#### #   ###
###     ####
####x#  s###
############