############
###     ####
### x  m####
###       ##
###     # ##
###     # ##
#### s ##n##
############