############
##m     s###
###    m####
####   #n###
### # #  ###
###     ####
###      ###
############
