############
####### ####
#####   ####
##### # ####
#####m# ####
###n  #s####
##### #m####
############