############
###s x######
####   #####
####   #####
####    n###
####x#m#####
####  m#####
############